IP,OS,NIC,Compiler,PASSED,FAILED,BLOCKED,Not Run,Grand Total
Grand Total, N/A, N/A, N/A,8528,257,14,636,9435
10.238.54.210,UB1804,carlsville,gcc,129,5,0,0,134
10.239.250.18,CentOS7.6,columbiaville_100g,gcc,84,16,5,0,105
10.238.54.221,RHEL80,columbiaville_25g,gcc,86,20,0,0,106
10.238.54.215,UB1804,columbiaville_25g,gcc,90,16,0,0,106
10.240.176.142,RHEL8,fortpark_TLV,gcc,168,6,0,0,174
10.240.176.194,UB1610,fortpark_TLV,gcc,100,1,0,0,101
10.240.176.184,Ubuntu18.04,fortpark_TLV,gcc,224,8,0,0,232
10.240.176.189,Ubuntu1804,fortpark_TLV,gcc,59,2,0,0,61
10.240.176.226,UB1604-11,fortvile_bdw_de,gcc,346,0,0,0,346
10.240.176.226,UB1604-12,fortvile_bdw_de,gcc,82,0,0,0,82
10.240.176.226,UB1604-22,fortvile_bdw_de,gcc,82,0,0,0,82
10.240.176.226,UB1604-24,fortvile_bdw_de,gcc,82,0,0,0,82
10.238.54.219,CentOS76,fortville_25g,gcc,313,5,0,0,318
10.240.176.247,RHEL8,fortville_25g,gcc,0,0,0,101,101
10.238.54.216,UB1404,fortville_25g,gcc,72,1,0,0,73
10.240.176.194,UB1610,fortville_25g,gcc,54,0,0,0,54
10.240.176.207,Ubuntu1404,fortville_25g,gcc,25,0,0,0,25
10.240.176.223,ubuntu1604,fortville_25g,gcc,130,0,5,0,135
10.240.176.151,Centos7.6,fortville_eagle,clang,233,7,0,0,240
10.240.176.151,Centos7.6,fortville_eagle,gcc,11,0,0,0,11
10.240.176.247,RHEL8,fortville_eagle,gcc,0,0,0,101,101
10.240.176.147,UB1604-11,fortville_eagle,gcc,82,0,0,0,82
10.240.176.187,UB1604-11,fortville_eagle,gcc,357,0,0,0,357
10.240.176.221,UB1604-11,fortville_eagle,gcc,82,0,0,0,82
10.240.176.147,UB1604-113,fortville_eagle,gcc,329,0,0,0,329
10.240.176.221,UB1604-113,fortville_eagle,gcc,310,0,0,0,310
10.240.176.147,UB1604-12,fortville_eagle,gcc,82,0,0,0,82
10.240.176.187,UB1604-12,fortville_eagle,gcc,76,0,0,0,76
10.240.176.221,UB1604-12,fortville_eagle,gcc,82,0,0,0,82
10.240.176.147,UB1604-123,fortville_eagle,gcc,46,0,0,0,46
10.240.176.221,UB1604-123,fortville_eagle,gcc,46,0,0,0,46
10.240.176.147,UB1604-22,fortville_eagle,gcc,82,0,0,0,82
10.240.176.187,UB1604-22,fortville_eagle,gcc,76,0,0,0,76
10.240.176.221,UB1604-22,fortville_eagle,gcc,82,0,0,0,82
10.240.176.147,UB1604-223,fortville_eagle,gcc,46,0,0,0,46
10.240.176.221,UB1604-223,fortville_eagle,gcc,46,0,0,0,46
10.240.176.147,UB1604-24,fortville_eagle,gcc,82,0,0,0,82
10.240.176.187,UB1604-24,fortville_eagle,gcc,76,0,0,0,76
10.240.176.221,UB1604-24,fortville_eagle,gcc,82,0,0,0,82
10.240.176.147,UB1604-243,fortville_eagle,gcc,46,0,0,0,46
10.240.176.221,UB1604-243,fortville_eagle,gcc,46,0,0,0,46
10.240.176.147,UB1604-363,fortville_eagle,gcc,46,0,0,0,46
10.240.176.209,UB1804,fortville_eagle,gcc,285,1,0,0,286
10.240.176.202,Ubantu1610,fortville_eagle,gcc,183,1,0,0,184
10.238.54.211,Ubuntu1804,fortville_eagle,gcc,59,4,0,1,64
10.240.176.196,Ubuntu1904,fortville_eagle,gcc,0,0,0,232,232
10.238.54.220,redhat8,fortville_eagle,gcc,94,1,0,0,95
10.240.176.141,Fedora30,fortville_spirit,gcc,138,1,0,0,139
10.240.176.197,RHEL7.6,fortville_spirit,gcc,190,3,0,0,193
10.240.176.147,UB1604-virtio,fortville_spirit,gcc,1,0,4,0,5
10.238.54.218,UB1804,fortville_spirit,icc,247,1,0,0,248
10.238.54.222,UB1804,fortville_spirit,gcc,15,3,0,3,21
10.238.54.213,Ubuntu1804,fortville_spirit,gcc,5,0,0,0,5
10.238.54.217,Ubuntu1804,fortville_spirit,gcc,55,2,0,1,58
10.240.176.189,Ubuntu1804,fortville_spirit,gcc,100,3,0,0,103
10.240.176.170,UB1604-11,magnolia_park,gcc,224,0,0,0,224
10.240.176.170,UB1604-22,magnolia_park,gcc,82,0,0,0,82
10.240.176.170,UB1604-33,magnolia_park,gcc,82,0,0,0,82
10.240.176.170,UB1604-44,magnolia_park,gcc,82,0,0,0,82
10.240.176.254,CentOS76,niantic,gcc,118,5,0,0,123
10.240.176.254,CentOS76,niantic,clang,117,6,0,0,123
10.240.176.134,FreeBSD12,niantic,clang,78,46,0,0,124
10.240.176.134,FreeBSD12,niantic,gcc,78,46,0,0,124
10.240.176.142,RHEL8,niantic,gcc,168,2,0,0,170
10.240.176.144,Suse12Sp3,niantic,gcc,150,1,0,0,151
10.238.54.216,UB1404,niantic,gcc,57,1,0,0,58
10.238.54.215,UB1804-cascade,niantic,gcc,262,2,0,0,264
10.240.176.207,Ubuntu1404,niantic,gcc,67,1,0,4,72
10.238.54.213,Ubuntu1804,niantic,gcc,61,1,0,1,63
10.238.54.220,redhat8,niantic,gcc,44,7,0,0,51
10.240.176.197,RHEL7.6,powerville,gcc,233,5,0,0,238
10.240.176.247,RHEL8,powerville,gcc,24,0,0,0,24
10.240.176.192,CentOS76,sagepond,gcc,88,2,0,0,90
10.238.54.219,CentOS76,sageville,gcc,161,15,0,0,176
10.240.176.192,CentOS76,sageville,gcc,38,0,0,0,38
10.240.176.189,Ubuntu1804,sageville,gcc,4,0,0,0,4
10.240.176.184,Ubuntu18.04,springville,gcc,185,8,0,0,193
10.240.176.151,Centos7.6,twinpond,gcc,0,0,0,192,192
10.238.54.218,UB1804,twinpond,icc,181,2,0,0,183
